ADN = "countries/Aden.txt"
BHR = "countries/Bahrain.txt"
BRN = "countries/Brunei.txt"
BST = "countries/Basutoland.txt"
FCA = "countries/French Central Africa.txt"
FIC = "countries/French Indochina.txt"
FWA = "countries/French West Africa.txt"
KAN = "countries/Kansu.txt"
NBR = "countries/North Borneo.txt"
NCH = "countries/North China.txt"
SKM = "countries/Sikkim.txt"
SML = "countries/Somaliland.txt"
SWK = "countries/Sarawak.txt"
SWZ = "countries/Swaziland.txt"
TSI = "countries/Tsinghai.txt"
ZNB = "countries/Zanzibar.txt"

# Unfederated Malay States
JHR = "countries/Johor.txt"
KDH = "countries/Kedah.txt"
KLT = "countries/Kelantan.txt"
PLS = "countries/Perlis.txt"
TNG = "countries/Terengganu.txt"

# Chinese T'u-ss≈≠
ARK = "countries/Arik.txt"
CHH = "countries/Chiang Hung.txt"
MNS = "countries/Mangshih.txt"
MUL = "countries/Muli.txt"
LNT = "countries/Lingtsang.txt"
NGC = "countries/Nangchen.txt"
NGL = "countries/Ninglang.txt"
TKP = "countries/Trokyap.txt"
YSH = "countries/Yushu.txt"

#Congo Crisis successor states
KAT = "countries/Katanga.txt"
RCO = "countries/Congo-Leopoldville.txt"
SKS = "countries/South Kasai.txt"